11 11 5
***********
***********
***********
***********
***********
***********
***********
***********
***********
***********
***********

***********
***********
***********
***********
***********
***********
***********
***********
***********
***********
***********

********** 
*    *   * 
*    *   * 
*    *   * 
*    *   * 
********** 
*    *   * 
*    *   * 
*    *   * 
********** 
           

***********
***********
***********
***********
***********
***********
***********
***********
***********
***********
***********

***********
***********
***********
***********
***********
***********
***********
***********
***********
***********
***********
