11 11 1
********** 
*    *   * 
*    *   * 
*    *   * 
*    *   * 
********** 
*    *   * 
*    *   * 
*    *   * 
********** 
           
