15 10 1
**********
*        *
*  *d*   *
*  * *   *
*  ***   *
*        *
*  *D*   *
*  * *   *
*  *d*   *
*        *
*  ***   *
*  *     *
*  ***  d*
*        *
**d*******
