9 39 1
***************************************
*   *   *   *   *   *   *   *   *   * *
* * * * * * * * * * * * * * * * * * * *
* * * * * * * * * * * * * * * * * * * *
* * * * * * * * * * * * * * * * * * * *
* * * * * * * * * * * * * * * * * * * *
* * * * * * * * * * * * * * * * * * * *
* *   *   *   *   *   *   *   *   *   *
***************************************
